11111111111111
1CCCCCCCECC1C1
1CCCCCCCCCC1C1
1CCCPCCCCCCCC1
11111111111111
10000000000001
11111111111111