111111111111111111
1000000011111E1001
1C1000100CCC0010C1
111000111111111001
1C10000CCC000C1001
101000011000001C01
101111111110000001
1P000CCC00100001C1
1000111110000001C1
111111111111111111